111101
1PCEE1
111111
111111
111111
111111