1111111111111111111111111111
1P0000000000V01EC000000000C1
1011111000111111111011111111
100010000000V01C00000C000001
1C11111111111011110000000001
1000100000000C10000001110001
1011111000111110110000000001
100C1C000000V0000000C0000001
1011111111111011110001110001
1000000000000000000000000001
1111111111111111111111111111
