11111111111
100V00000V1
100000C0001
1CP00100001
100E0000C01
10000V00001
11111111111