111111111111111111111111111111
1CCCCCCCCCCCCCCCCCCCCCCCCCCCC1
1CCCCCCCC111CCC11111111111CCC1
1CCCCCC11111CCC1111111111CCCC1
1CCCCC111C11CCC111CCCC111CCCC1
1CCCC111CC11CCCCCCCCC111CCCCC1
1CCC111CCC11CCCCCCCC111CCCCCC1
1CC111CCCC11CCCCCCC111CCCCCCC1
1CC11CCCC111CCCCCC111CCCCCCCC1
1C11111111111CCCC111CCCCCCCCC1
1CCCCCCC111CCCCC111CCCCCCCCCC1
1PCCCCCC111CCCC111CCCCCCCCCCC1
1CCCCECC111CCC111111111111CCC1
1CCCCCCC111CCC111111111111CCC1
1CCCCCCCCCCCCCCCCCCCCCCCCCCCC1
111111111111111111111111111111