111111111111111111111111111111
1C000010E0000000001000000001C1
100000100000001V00100000000101
100000100000001000100000001101
1V0V0V1C0000001011100000001001
1000001111111110000000000010V1
100000000000000000000000001001
1000000000V0000000000000001101
1111010000000000000000000001C1
100001000000000000000000000101
10000100000000000000000000C101
10VVV1000000000000111111111101
100001000V000000000000000P0101
1000C1C00000000000000000000001
111111111111111111111111111111