11111
1P001
10V01
10C01
100E1
11111
