1111111111111111
1C11000000000111
10000V0001CV1001
1000000000000001
10000100000000E1
1000000011110001
10P000001C110001
1000000010110001
1111111110000001
1C00000000V00001
1111111111111111
