111111111111111111111111
1C1100000000000000011111
10000V0001CV100000001C11
111100000111100000111011
100000000000100000000011
100011000011100000111111
100001000010100000000001
100000000011100000000001
1000010000000010000000E1
100000001111000000000001
10P000001C11000001111101
10000000101100000100C101
11111111100000000101V101
1C00000000V00000010000C1
111111111111111111111111
